1.941683578491210938e+01
1.395803737640380859e+01
1.233763790130615234e+01
1.222715377807617188e+01
1.163903617858886719e+01
1.155820751190185547e+01
1.153378868103027344e+01
1.163873958587646484e+01
1.139607524871826172e+01
1.156793975830078125e+01
1.115371036529541016e+01
1.105928993225097656e+01
1.127065372467041016e+01
1.058504486083984375e+01
1.101280498504638672e+01
1.098033237457275391e+01
1.096420478820800781e+01
1.074453258514404297e+01
1.071059417724609375e+01
1.054125308990478516e+01
1.103468704223632812e+01
1.058449172973632812e+01
1.078201293945312500e+01
1.073042869567871094e+01
1.055884075164794922e+01
1.060511112213134766e+01
1.063963127136230469e+01
1.065006256103515625e+01
1.056291770935058594e+01
1.053364467620849609e+01
1.045451164245605469e+01
1.041492271423339844e+01
1.048561477661132812e+01
1.043967723846435547e+01
1.021484470367431641e+01
1.030892944335937500e+01
1.024668884277343750e+01
1.031193447113037109e+01
1.012153339385986328e+01
1.015142536163330078e+01
1.031324195861816406e+01
1.026152420043945312e+01
1.025812053680419922e+01
1.020264625549316406e+01
1.007387828826904297e+01
1.019424533843994141e+01
1.019198799133300781e+01
1.019071388244628906e+01
1.015013790130615234e+01
1.009231281280517578e+01
1.013401699066162109e+01
1.012159252166748047e+01
1.006999969482421875e+01
1.004464721679687500e+01
1.004823684692382812e+01
1.004879760742187500e+01
1.008004188537597656e+01
1.003331661224365234e+01
1.001120662689208984e+01
9.909408569335937500e+00
9.948735237121582031e+00
9.879057884216308594e+00
9.935044288635253906e+00
9.941279411315917969e+00
9.854993820190429688e+00
9.978184700012207031e+00
9.916187286376953125e+00
9.874448776245117188e+00
9.806913375854492188e+00
9.884244918823242188e+00
9.871140480041503906e+00
9.817748069763183594e+00
9.833884239196777344e+00
9.776769638061523438e+00
9.830246925354003906e+00
9.801987648010253906e+00
9.774190902709960938e+00
9.818380355834960938e+00
9.775328636169433594e+00
9.783637046813964844e+00
9.787713050842285156e+00
9.707556724548339844e+00
9.679818153381347656e+00
9.778939247131347656e+00
9.676959037780761719e+00
9.652779579162597656e+00
9.660869598388671875e+00
9.724607467651367188e+00
9.637896537780761719e+00
9.661314010620117188e+00
9.578338623046875000e+00
9.758318901062011719e+00
9.624020576477050781e+00
9.587980270385742188e+00
9.593402862548828125e+00
9.625205039978027344e+00
9.612768173217773438e+00
9.619348526000976562e+00
9.599278450012207031e+00
9.583963394165039062e+00
